0011111100
0122222210
1122112211
1100110011
2200000022
2200000022
1100110011
1122112211
0122222210
0011111100
0000000000