3300000033
3311001133
2211111122
1122222211
0122332210
0012332100
0001221000
0000110000
0011001100
0011001100
0000000000