3333333333
3000000003
3033333303
3030000303
3030330303
3030300303
3030333303
3030000003
3033333333
3000000000
3333333330

