0000111110
0001100011
0211000001
2000002301
1111003301
1000000001
1111002301
2000003301
0211000001
0001100011
0000111110