0011111100
0122222210
1233223321
1233223321
1222222221
0122222210
1122222211
1100110011
2200000022
3300000033
0000000000