3333333333
3300330033
3300330033
0011221100
0011221100
3300330033
3300330033
2211111122
2211111122
1111111111
0000000000