1











3311111133
3322222233
0022222200
0011111100
0011111100
1111111111
2222222222
2200000022
3300000033
3300000033
0000000000