0000000000
0000000000
0000001110
0001110011
0111002301
1100000001
0111002301
0001110011
0000001110
0000000000
0000000000